XXXXXXXXX XXXXXXX
X       X     X X
X XXXXX X X X X X
X X   X   X X   X
X X X XXXXX XXX X
X   X X   X X X X
XXXXX XXX X X X X
X   X     X X X X
XXX XXXXXXX X X X
X X X       X   X
X X X XXXXXXX XXX
X   X     X X X X
X XXXXXXX X X X X
X         X     X
XXXXXXXXX XXXXXXX
